0000000000000000000000000000000000000000000000000000000000000000
0000000000000000000000000000000000000000000000000000000000000000
00000000000000D111111111111111111111111111111S000000000000000000
000000000000001D1111111111111111111111111111S1000000000000000000
0001100110000011D11111111111111111111111111S11000000000000000000
00011001100000111D111111111111111111111111S111000110000011000000
000011000000001111D1111111111111111111111S1111000110000011000000
0000110000000011111D11111111111111111111S11111000000000000000000
0000000000000011111100000000000000000000111111000001100000000000
0011000000000011111100000000000000000000111111000001100000000000
0011000000000011111100000000000000000001111111000000000000000000
00000D11111111Z1111100000000000000000001111111000000000000000000
000001D11111111Z111100000000000001100000111111000000000000000000
0000011D11111111Z11100000000000001100110111111000000000000000000
00000111D11111111Z1100000000000000000110111111110000000000000000
000001111D11111111Z100000000000000000000111111110110000000000000
0000011111D11111111Z00110000000000000000111111000110000000000000
0000011111100000000000110000000000000000111111000000000000000000
0000011111100000000000000000000011000000111111000000000000000000
0000011111100000000000000000000011000000111111000000000001100000
0000011111100001100000000000000000000000111111000000000001100000
0000111111100001100000000000000000000000111111000000000000000000
000011111110000000000000000000000000000011111D11111111111111111F
00000111111000000000000000000000000000001111D111111111111111111F
0000011111100000000000000000000000000000111D1111111111111111111F
000001111110000000000000000000000000110011D11111111111111111111F
00000111111000000110000000000000000011001D111111111111111111111F
0110011111100000011000000000000000000000D1111111111111111111111F
0110011111100000000000000000000011000000000000000000000000000000
0000011111100000000000000000000011000000000000000000000000000000
0000011111100000000000000000000001100000000000000000000000000000
0000011111100000000000000000000001100000000000000000000000000000
0000011111100000000000000000000000000000000000000000000000000000
0000011111100000000000000000000000000000000000000000000000000000
0000011111100000000000000000000000000000000000000000000000000000
00000ZZZZZZ00000000000000000000000000000000000000000000000000000
