0000000000000000000000000000000000000000000000000000000000000000
1S11111111111111111Q00000000000000000000000000000000000000000011
11S111111111111111Q1000000000D111111111111111111111111111111111F
111S1111111111111Q110000000001D11111111111111111111111111111111F
1111S11111111111Q11100000000011D1111111111111111111111111111111F
11111S111111111Q1111000000000111D111111111111111111111111111111F
111111S1111111Q111110000000001111D11111111111111111111111111111F
1111111000000111111100000000011111D1111111111111111111111111111F
1111110000000011111100000000011111110000000000000000000000000000
11111110000000111111000000001R1111100000000000000000000000000000
111111D11111111111111111111111R1RRR00000000000000000000000000000
11111D1111111111111111111111111R11100000000000000000000000000000
1111D111111111111111111111111111RRR00000000000000000000000000000
111D111111111111111111111111111R11100000000000000000000000000000
11D111111111111111111111111111R111100000000000000000000000000000
1D111111111111111111111111111R1111100000000000000000000000000000
0000000000000011111100000000111111100000000000000000000000000000
1100000000000111111100000000011111110000000000000000000000000000
D111111111111111Z1100000000011111D11111111111111111111111111111F
D111111111111111Z1110000000001111D11111111111111111111111111111F
D111111111111111Z111000000000111D111111111111111111111111111111F
D1111111111111111Z1100000000011D1111111111111111111111111111111F
D11111111111111111Z10000000001D11111111111111111111111111111111F
D111111111111111111Z000000000D111111111111111111111111111111111F
0000000000000000011000000000000000000000000000000000000000000000
0000000000000000000000000000000000000000000000000000000000000000
0000000000000000000000000000000000000000000000000000000000000000
0000000000000000000000000000000000000000000000000000000000000000
0000000000000000000000000000000000000000000000000000000000000000
0000000000000000000000000000000000000000000000000000000000000000
0000000000000000000000000000000000000000000000000000000000000000
0000000000000000000000000000000000000000000000000000000000000011
0000000000000000000000000000000000000000000000000000001111000011
0011000000000000000000000000000000000000000000000000001111000000
0011000000000000000000000000000000000000000000000000000000000000
0000000000000000000000000000000000000000000000000000000000000000
