00000000000000SSSSSS00000000000000000000000000000000000000000000
0000000000000011111100000000000000000000000000000000000000000000
0000000000000011111100000000000000000000000000000000000000000000
0000000000000011111D111111111111111S0000000000000000000000000000
000110000000001111D111111111111111S10000000000000000000000110000
00011000000000111D111111111111111S110000000000000000000000110000
0011000000000011D111111111111111S1110000000000000000000001101100
001100000000001D111111111111111S11110000000000000000000001101100
00000000000000D111111111111111S111110000000000000000000000000000
0000000000000000000000000000001111110000000000000000000000000000
0000000000000000000000000000001111110000000000000000000000000000
0000000000000000000000000000001111110000000000000000000000000000
0000000000000000000000000000001111110000000000000000000000000000
0000000000000000000000000000001111110000000000000000000000000000
0000000000000000000000000000001111110000000000000000000000000000
D1111111111S1111D111111111111FFFFFFF11111111111111111111QQ000000
D1111111111S1111D111111111111FF0000F111111111111111111QQ11000000
D1111111111S1111D111111111111FF0000F11111111111111111Q1110000000
D111111111S111111D11111111111FF0000F1111111111111111Q11110000000
D11111111S11111111D1111111111FF1111F1111111111111111111111000000
D1111111S1111111111D111111111FF1111F1111111111111111111111000000
00000000111D1111Z11100000000000000000000000000000000111111000000
00000000111D1111Z11100000000000000000000000000000000111111000000
0000000011D111111Z1100000000000000000000000000000000111111000000
000000001D11111111Z100000000000000000000000000000000111Z1111111Q
00000000D1111111111Z0000000000000000000000000000000011Z11111111Q
00000000000000000000000000000000000000000000000000001Z111111111Q
0000000000000000000000000000000000000000000000000000Z1111111111Q
00000000000000000000000000000000000000000000000000001Z111111111Q
0000000000000000000000000000000000000000000000000000Z1111111111Q
0001100000000000000000000000000000000000000000000000000000001100
0001100000000000000000000000000000000000000000000000000000011000
0000000000000000000000000000000000000000000000000000000000011000
0000000000000000000000000000000000000000000000000000000000000000
0000000000000000000000000000000000000000000000000000000000000000
0000000000000000000000000000000000000000000000000000000000000000
