000000000000000000000000000011000000000000000000000000000000
000110011000000000000000000011000000000000000000000000000000
00011001100000D111111111111111111111111111111S00011000001100
000011000000001D1111111111111111111111111111S100011000001100
0000110000000011D11111111111111111111111111S1100000000000000
00000000110000111D111111111111111111111111S11100000110000000
001100001100001111D1111111111111111111111S111100000110000000
0011000000000011111D11111111111111111111S1111100000000000000
000000000000001111110000000000000000000111111100000000000000
000000000000001111110000000000000110000011111100000000000000
000000000000001111110000000000000110011011111100000000000000
00000D11111111Z111110000000000000000011011111100000000000000
000001D11111111Z11110000000000000000000011111100000000000000
0000011D11111111Z1110011000000000000000011111100000000000000
00000111D11111111Z110011000000000000000011111100000000000000
000001111D11111111Z10000000000001100000011111100000000000000
0000011111D11111111Z0000000000001100000011111100000000000110
000001111110001111100000000000000000000011111100000000000110
000011111110001111100000000000000000000011111100000000000000
000011111110001111100000000000000000000011111100000000000000
000001111110001111100000000000000000000011111100001100000000
000001111110000000000000000000000000000011111100001100000000
000001111110000000000000000000000000110011111D11111111111111
00000111111000000110000000000000000011001111D111111111111111
0110011111100000011000000000000000000000111D1111111111111111
011001111110000000000000000000001100000011D11111111111111111
00000111111000000000000000000000110000001D111111111111111111
0000011111100000000000000000000001100000D1111111111111111111
000001111110000000000000000000000110000000000000000000000000
00000ZZZZZZ0000000000000000000000000000000000000000000000000
