11111111111111111111111111111111E
10000000000000000000000000000000E
00000000000000000000000000000000E
00000000000000000000000000000000E
10000000000000000000000000000000E
00011001100001000011000100001000E