50
o...o..oo..ooo..o.........o..o..oo.....oo.o.o....o
oo..o...o.........o..o..ooo.oo..o..oo.......o...oo
o...ooo.o.o...o.o.....o..o........o...o...oo.....o
o.....o.o............o...o.o....o...o..o.........o
oo.o......o..o........o...ooo......o......o.o....o
oo....o...oo....o.......o..o....oo....oo....o....o
oo.....oo..o..o................o...o....oo.......o
o......o.......oo..o.o..oooo.o.................ooo
oo...o....o.........o..o.....o....oo..o..o.....o.o
oo......o..oo.....oo..........o....o.o..o..o.oo.oo
o.......o.....o...........o..ooo.o..o....o.o...o.o
o.o..o...o.o..o...o.o.o..........o....oo....o..ooo
o.....oo...oo..oo..o...o...............o.......o.o
o.....o.o...o.o...............ooooo.o..o.........o
ooo.o.o.....o.......o....o.o...oooo...oo......o..o
oooo..o......ooo..............o......o........o..o
o.........ooo..o......o.oooo.....o......o..o.....o
o...o.oo..............ooo.o...oo.....o........o..o
o...o....o.o...........o...o.o.o..o......o...o...o
o........o.o....o..o...oo............o.ooo...o...o
o...o.o..oo..o..o...o.o.......o.oo..o.....oo.o...o
oooo..........o..o..oo....o.o..o....oo....oo.....o
oo......o..o.o..o....oo..o.....o.................o
oo....o........o.....o...o.o.....ooo.......oo....o
o.ooo..o...oo..o...........o..oo.....o...o..oo...o
oo.o....o..oo.o.....oo..oo.oo...oo.....o...oo.o..o
oo.....o.oooo.oo.oo........o.........ooo.....oo..o
o.o.oo.....o......oo......oooo.o.....o.oo..o.o..oo
o.o............ooo..o...............o.o.o.......oo
o..o......o.......o.o..o.o.o...o.o.o.............o
o..o.....o....o....o.....o.....oo......o...oo...oo
o....o.....o....o.o......o.o.o..o..o...oo.....o..o
o..oo..oo.o......o.......o.o.....................o
o.........o..o.o..o..o.......o..o...........oo...o
oo.........ooo...o.o..............oo..o.....o....o
o....o.o.o..o..o..........oo...o..o............o.o
oo..........o..o.........o....oooo..o.....o..o.o.o
o.oo.o..o.....o.o......oo.o......o...o...oo..o..oo
oo.o...oooo..o.....o.....o.o.oo......o..o.o.o.o..o
oooo..ooo.o..o.oo.....o....o........o..o..o.o..o.o
o.........o....o..o.....o.o........o...o...o.....o
o......o....ooo...o....ooo....o.o.o..o.oo.......oo
o.o.oo....oo...o........o.....o..oo.......oo...o.o
oo.o.oooo..o.oo...o....o.....o..o......o.........o
oo......o..ooo...........oo..o...o...oo..o.....ooo
o.....o..o....o.o.....o.....ooo....o..o........ooo
o.........o.oo.....oo..o..oo.oo..o........o..o...o
o...o..o.o.....o.......o..o...o.........oo...o...o
o.o...o.......o.o.....o...o.o.....oo...o..o...o..o
ooo.o.o..o.......o.....o.....o.o...o..o...o.....oo
